1111111111111111111111111111111111111111111111111
1E00000000000000000000000000000000000000000000001
1000000000000000000000000000000000000000000000001
1000000000000000000000000000000000000000000000001
1000000000000000000000000000000000000000000000001
1000000000000000000000000000000000000000000000001
1000000000000000000000000000000000000000000000001
1000000000000000000000000000000000000000000000001
10000000000000000C0000000000000000000000000000001
1000000000000000000000000000000000000000000000001
1000000000000000000000000000000000000000000000001
1000000000000000000000000000000000000000000000001
1000000000000000000000000000000000000000000000001
1000000000000000000000000000000000000000000000111
1000000000000000000000000000000000000000000110101
1000000000000000000000000000000000000000111100101
1000000000000000000000000000000001zzzzzz100001101
100000000000000000000000001111111001111z101111001
100000000000000000000000001000000011zzzz100001011
10000000000000011111111111101111111zz111111101001
10000000000001110000010000001000001z11zzzzz101101
10000000000000000101010111111111101zzzz111z101001
100000000000011101011101000000000010111101z111011
100000000000010000000001011111111110100001zzzzzz1
10000000000001010111111101000100011010111111011z1
10000000000001010000000100010001000010000000001P1
1111111111111111111111111111111111111111111111111