1111111111
1000000E01
1000000001
100000C001
1P00000001
1111111111