111111111111111111111
1CCCCCCCC1E1CCCCCCCC1
1CCCCCCCCCCCCCCCXCCC1
1CCCXCCCCCCCCCCCCCC01
111111111111111111111