111111111111111111111
1CCCCCCCC101CCCCCCCC1
1CCCCCCCCCCCCCCCXCCC1
1CCCXCCCCCCCCCCCCCCP1
111111111111111111111