111111111111111111111
1CCCCCCCC1E1CCCCCCCC1
1CCCCCCCCCCCCCCCXCCC1
1CCCXCCCCCCCCCCCCCCP1
11111111111111111111