11111111111111111111111111111
1CCCCCCCC1E1CCCCCCCCCCCCCCCC1
1CCCCCCCC1C1CCCCXCCCCCCCCCCC1
1CCCCCCXCCCCCCCCCCCCCCCCCCCC1
1CCCCCCCCCCCCCCCCCCCCXCCCCCC1
1CXCCCCCCCCCCCCCCCCCCCCCCCCC1
1CCCCCCCCCCCCCCCXCCCCCCCCCCC1
1CCCCCCCCCCCCCCCCCCCCCCCXCCC1
1CCCXCCCCCCCCCCCCCCCCCCCCCCP1
11111111111111111111111111111